8
15
6
5
111111111111111
111000000000111
111011111011111
000000011011000
110111011000011
110001011011011
111100011111011
111111111111111
