8
15
5
2
111111111110111
111000000000111
111011111011111
000000011011000
110111011000011
110001011011011
111100011111011
111101111111111
